LLLLLLLLLLLLLLLLLLLLLLLLLLLLLLLLLLLLLLLLLLLLLLLLLLLLLLLLLLLLLLLLLLLLLLLLLLLLLLL
------C----H--------------H------------------H-------------------H----------CCC
-------CCCCH--------------C------------------H-------------------H-------------
---------------------------------------------H---------CCCCCCCC--H-------------
---------------------------------------------U-------------------U-------------
-------------------------------------------------------------------------------
-------------------------------------------------------------------------------
-------------------------------------------------------------------------------
----------CCCCCC--------------------------------------------N------------------
--------C------H---------------------------------------CCCC-H------------------
-------C-------H--------------------------------------------H------------------
------C--------H--------------------------------------------H------------------
TTTTTTTTTTTTTTTTTTTTTTTTTTTTTTTTTTTTTTTTTTTTTTTTTTTTTTTTTTTTTTTTTTTTTTTTTTTTTTT