LLLLLLL------------LLLLLLLL----LLLLLLLL-----LLLLLLL--------------------LLLLLLLL
-------------------------------------------------------------------------------
----------------------------------------------------CCCCCCCC-------------------
---------------------------------------CCCC------------------------------------
-------CCCCCCCCCCC------------------------------------------------------CCCCC--
-------------------------------------------------------------------------------
-------------------------------------------------------------------------------
-----------------------------------CCCC--------CCCC----------------------------
----------CCCCCCCC-------------------------------------------------------------
------------------H------------------------------------------CCCCCCCC----------
-------------------H-----------------------------------------------------------
-------H------------H----------------------------------------------------------
TTTTTTT-------------TTTTTTTTTTTTTTTT----TTTTTTTTT------TTTTTTTT------TTTTTTTTTT