LLLLLLLLL-----------------------LLLLLLLL----------------------LLLL-----------LL
--------H--------------------LLL-----------------------------------------------
--------LLLLLLLLL----------------------------------CCCC------------------------
-----------------LLLLLL-----------------------CCC------------------------------
-----------------------LLLL----------------------------------------------------
-------------------------------------------------------------------------------
-----------------------------------------CCCCCC--CC----------------------------
------------------------------------------------------CCCCCCC------------------
-----------------------CCCCT---------------------------------------------------
-----------------CCCCCC----H---TTTTT-------------------------------------------
---------CCCCCCCC----------H---H-----------------------------------------------
---------H-----------------H---H-----------------------------------------------
TTTTTTTT-------------------TTTT-T-----------------------------------TTTTTTTTTTT