LLLL-------LLLLLLLLLLLLLLLLLLLLLLLLLLLLLLLLLLLLLLLLLLLLLLLLLLLLLLLLLLLLLLLLLLLL
----------------------------CCCCCCH--------------------------------------------
----------------------------------H--------------------------------------------
----------------------------------H--------------------------------------------
----------------------------------H--------------------------------------------
----------------------------------H--------------------------------------------
-------------------------------------------------------------------------------
---------------------------CCCC--------H---------------------------------------
---------------H-----------------------H--------------------H------------------
---------------H-----------------------H--------------------H------------------
---------------H-----------------------H--------------------H------------------
---------------H-----------------------H--------------------H------------------
TTTTTTTTTTTTTTTT----------TTTTTTTTTTTTTTTTTTTTTTTTTTTTTTTTTTTTTTTTTTTTTTTTTTTTT