LLLLLLL------LLLLLLLLLLLLLLLLLLLLLLLLLLLLLLLLLLLLLL--------------------LLLLLLLL
---------------------------------------H---------------------------------------
---------------------------------------H------------CCCCCCCC-------------------
---------------------------------------H---------------------------------------
-------CCCCCCC----------------------------------------------------------CCCCC--
-------------------------------------------------------------------------------
-------------------------------------------------------------------------------
-----------------------------------CCCC----------------------------------------
-------------------------------------------------------------------------------
--------------CCCCC----------H-------------------------------CCCCCCCC----------
------------C----------------H-------------------------------------------------
----------C------------------H-------------------------------------------------
TTTTTTTTTTTTTTTTTTTTTTTTTTTTTTTTTTTT----TTTTTTTTT------TTTTTTTT------TTTTTTTTTT