LLLL--LLLLLLL----LLLLLL----LLLLL----LLLL----------LLLLL----------------------LLLLL
----------------------------------------------------------------------------------
----------H------H-------------------------------------------CCCCC----------------
-----------CCCCCC------CCCC----CCCCC---CCC----------------------------------------
----CCC---------------------------------------------------------------------------
-----------------------------------------------------------------------CCCC-------
--------------------------------------------------------CCCCC---------------------
----------------------------------------------------------------------------------
----CCC----CCCCCCCC----CCC-----CCC------------------------------------------------
----------H--------------------------------CCCCC------------------CCCCC-----------
----------H-----------------------------------------------------------------------
----------H-------CCCC----CCCCC---CCC---------------------------------------------
TTTT--TTTTT-----------------------------------------------------------------TTTTTT