LLLLLLLLLLLLLLLLLLLLLLLLLLLLLLLLLLLLLLLLLLLLLLLLLLLLLLLLLLLLLLLLLLLLLLLLLLLLLLL
--------------------------H------------------H-------------------H----------CCC
--------------------------H------------------H-------------------H-------------
---------------------------------------------H---------CCCCCCCC--H-------------
---------------------------------------------H-------------------H-------------
-------------------------------------------------------------------------------
-------------------------------------------------------------------------------
-----------------------------CCCCC---------------------------------------------
---------------H--------------------------------------------H------------------
---------------H---------------------------------------CCCC-H------------------
---------------H--------------------------------------------H------------------
---------------H--------------------------------------------H------------------
TTTTTTTTTTTTTTTTTTTTTTTTTTTTTTTTTTTTTTTTTTTTTTTTTTTTTTTTTTTTTTTTTTTTTTTTTTTTTTT